################
#......##......#
#......##......#
#..............#
#..............1
#..............#
#..............#
#..............#
#..............#
#..............#
#..............#
#..............#
#..............#
#..............#
##.............#
################
7,3
1
0
2,4,14