################
#......##......#
#......##......#
#..............#
0..............#
#..............#
#..............#
#..............#
#..............#
#..............#
#..............#
#..............#
#..............#
#..............#
##.............#
################
7,3
1
13
1,1,1
1,3,1
1,5,1
1,14,1
1,12,1
1,10,1
1,2,13
2,14,14
2,12,14
2,10,14
2,8,14
2,6,14
2,4,14