################
#..............#
#..............#
#..............#
#..............#
#..............#
#..............#
#..............1
#..............1
#..............#
#..............#
#..............#
#..............#
#..............#
#..............#
################
3,7
1
4
2,13,2
2,13,13
4,1,1
3,1,14