#######2-2#######
#..............#
#..............#
#..............#
#..............#
#..............#
#..............#
0..............#
0..............#
#..............#
#..............#
#..............#
#..............#
#..............#
#..............#
#######3-3#######
1,1
1
4
1,14,1
1,14,14
3,7,7
3,8,8