#######2-2#######
#..............#
#..............#
#..............#
#..............#
#..............#
#..............#
0..............#
0..............#
#..............#
#..............#
#..............#
#..............#
#..............#
#..............#
#######3-3#######
1,1
1
2
1,7,7
1,8,8