################
#..............#
#..............#
#..............#
#..............#
#..............#
#..............#
#..............4
#..............4
#..............#
#..............#
#..............#
#..............#
#..............#
#..............#
#######1-1#######
1,1
1
13
1,1,1
1,3,1
1,5,1
1,14,1
1,12,1
1,10,1
1,2,13
2,14,1
2,12,1
2,10,1
2,8,1
2,6,1
2,4,1
2,2,1