################
#..............#
#..............#
#..............#
#..............#
#..............#
#..............#
2..............6
2..............6
#..............#
#..............#
#..............#
#..............#
#..............#
#..............#
################
1,1
1
0