################
#..............#
#..............#
#..............#
#..............#
#..............#
#..............#
3..............7
3..............7
#..............#
#..............#
#..............#
#..............#
#..............#
#..............#
################
1,1
1
0