################
#..............#
#..............#
#..............#
#..............#
#..............#
#..............#
4..............#
4..............#
#..............#
#..............#
#..............#
#..............#
#..............#
#..............#
#######8-8#######
1,1
1
0