#######8-8#######
#..............#
#..............#
#..............#
#..............#
#..............#
#..............#
5..............#
5..............#
#..............#
#..............#
#..............#
#..............#
#..............#
#..............#
################
1,1
1
0