#######6-6#######
#..............#
#..............#
#..............#
#..............#
#..............#
#..............#
9..............#
9..............#
#..............#
#..............#
#..............#
#..............#
#..............#
#..............#
#######7-7#######
1,1
1
0