################
#..............#
#..............#
#..............#
#..............#
#..............#
#..............#
#..............8
#..............8
#..............#
#..............#
#..............#
#..............#
#..............#
#..............#
#######10-10#######
1,1
1
0